100000090000006
000000090000000
000000000000000
000000090000000
600000090000002